//MAP CONVERTED BY dmm2tgm.py THIS HEADER COMMENT PREVENTS RECONVERSION, DO NOT REMOVE
"a" = (
/obj/effect/backdrop/beach,
/obj/effect/landmark/club_penguin_corner1,
/turf/cordon,
/area/club_penguin/beach)
"h" = (
/turf/cordon,
/area/club_penguin/beach)
"n" = (
/obj/effect/landmark/club_penguin_corner2,
/turf/cordon,
/area/club_penguin/beach)
"s" = (
/obj/effect/teleport_transition{
	club_penguin_area_type = /area/club_penguin/ski_village
	},
/turf/open/floor/grass/snow/actually_safe,
/area/club_penguin/beach)
"v" = (
/obj/effect/teleport_transition{
	club_penguin_area_type = /area/club_penguin/town
	},
/turf/open/floor/grass/snow/actually_safe,
/area/club_penguin/beach)
"L" = (
/obj/effect/landmark/area_ambience/beach,
/turf/cordon,
/area/club_penguin/beach)
"Y" = (
/turf/open/floor/grass/snow/actually_safe,
/area/club_penguin/beach)

(1,1,1) = {"
h
h
h
h
h
h
h
h
h
h
h
h
h
h
a
"}
(2,1,1) = {"
h
h
h
h
h
h
Y
Y
Y
h
h
h
h
h
L
"}
(3,1,1) = {"
h
h
h
h
h
h
h
Y
Y
h
h
h
h
h
h
"}
(4,1,1) = {"
h
h
h
h
h
h
h
h
Y
Y
h
h
h
h
h
"}
(5,1,1) = {"
h
h
h
h
h
h
Y
Y
Y
Y
h
h
h
h
h
"}
(6,1,1) = {"
h
h
h
h
h
h
Y
Y
Y
Y
Y
h
h
h
h
"}
(7,1,1) = {"
h
h
h
h
h
h
Y
Y
Y
Y
Y
h
h
h
h
"}
(8,1,1) = {"
h
h
h
h
h
h
Y
Y
Y
Y
Y
Y
Y
Y
h
"}
(9,1,1) = {"
h
h
h
h
Y
Y
Y
Y
Y
Y
Y
Y
Y
Y
h
"}
(10,1,1) = {"
h
h
h
h
Y
Y
Y
Y
Y
Y
Y
Y
Y
Y
h
"}
(11,1,1) = {"
h
h
h
Y
Y
Y
Y
Y
Y
Y
Y
Y
Y
Y
h
"}
(12,1,1) = {"
h
h
h
s
Y
Y
Y
Y
Y
Y
Y
Y
Y
Y
h
"}
(13,1,1) = {"
h
h
h
s
Y
Y
Y
Y
Y
Y
Y
Y
Y
Y
h
"}
(14,1,1) = {"
h
h
h
s
Y
h
Y
Y
Y
Y
Y
h
h
h
h
"}
(15,1,1) = {"
h
h
h
h
h
h
Y
Y
Y
Y
Y
h
h
h
h
"}
(16,1,1) = {"
h
h
h
h
h
h
v
v
Y
Y
h
h
h
h
h
"}
(17,1,1) = {"
h
h
h
h
h
h
h
h
h
Y
h
h
h
h
h
"}
(18,1,1) = {"
h
h
h
h
h
h
h
h
h
h
h
h
h
h
h
"}
(19,1,1) = {"
n
h
h
h
h
h
h
h
h
h
h
h
h
h
h
"}
