//MAP CONVERTED BY dmm2tgm.py THIS HEADER COMMENT PREVENTS RECONVERSION, DO NOT REMOVE
"f" = (
/obj/effect/teleport_transition{
	club_penguin_area_type = /area/club_penguin/town
	},
/turf/open/floor/iron/large,
/area/club_penguin/coffee_shop)
"i" = (
/obj/effect/landmark/club_penguin_corner2,
/turf/cordon,
/area/club_penguin/coffee_shop)
"w" = (
/obj/effect/landmark/club_penguin_corner1,
/obj/effect/backdrop/coffee_shop,
/turf/open/floor/iron/large,
/area/club_penguin/coffee_shop)
"F" = (
/turf/open/floor/iron/large,
/area/club_penguin/coffee_shop)
"P" = (
/obj/effect/landmark/area_ambience/coffee_shop,
/turf/open/floor/iron/large,
/area/club_penguin/coffee_shop)
"V" = (
/turf/cordon,
/area/club_penguin/coffee_shop)

(1,1,1) = {"
V
V
V
V
V
V
V
V
V
V
V
V
V
V
V
V
"}
(2,1,1) = {"
V
V
V
V
V
V
V
V
V
V
V
V
F
F
w
V
"}
(3,1,1) = {"
V
V
V
V
V
V
V
V
V
V
V
F
F
F
P
V
"}
(4,1,1) = {"
V
V
V
V
V
V
V
V
V
F
F
F
F
F
F
V
"}
(5,1,1) = {"
V
V
V
V
V
V
V
F
F
F
F
F
F
F
F
V
"}
(6,1,1) = {"
V
V
V
V
V
V
F
F
F
F
F
F
F
F
F
V
"}
(7,1,1) = {"
V
V
V
V
V
V
V
F
F
F
F
F
F
F
F
V
"}
(8,1,1) = {"
V
V
V
V
V
V
F
V
V
F
F
F
F
F
F
V
"}
(9,1,1) = {"
V
V
V
V
V
V
F
V
F
F
F
F
F
F
F
V
"}
(10,1,1) = {"
V
V
V
V
V
V
F
F
F
F
F
F
F
F
F
V
"}
(11,1,1) = {"
V
V
V
V
V
V
F
F
F
F
F
F
F
F
F
V
"}
(12,1,1) = {"
V
V
V
V
V
V
F
F
F
F
F
F
F
F
F
V
"}
(13,1,1) = {"
V
V
V
V
V
V
F
F
F
F
F
F
F
F
F
V
"}
(14,1,1) = {"
V
V
V
V
V
f
F
V
V
V
F
F
F
F
F
V
"}
(15,1,1) = {"
V
V
V
V
V
V
V
V
V
V
V
F
F
F
F
V
"}
(16,1,1) = {"
V
V
V
V
V
V
V
V
V
V
V
F
F
F
F
V
"}
(17,1,1) = {"
V
V
V
V
V
V
V
V
V
V
V
F
F
F
F
V
"}
(18,1,1) = {"
V
V
V
V
V
V
V
V
V
V
V
F
F
F
F
V
"}
(19,1,1) = {"
V
V
V
V
V
V
V
V
V
V
V
F
F
F
F
V
"}
(20,1,1) = {"
i
V
V
V
V
V
V
V
V
V
V
V
F
F
F
V
"}
(21,1,1) = {"
V
V
V
V
V
V
V
V
V
V
V
V
V
V
V
V
"}
