//MAP CONVERTED BY dmm2tgm.py THIS HEADER COMMENT PREVENTS RECONVERSION, DO NOT REMOVE
"a" = (
/obj/effect/barticle_bonfire,
/turf/open/floor/grass/snow/actually_safe,
/area/club_penguin/cove)
"i" = (
/obj/effect/landmark/club_penguin_corner2,
/turf/cordon,
/area/club_penguin/cove)
"k" = (
/obj/effect/teleport_transition{
	club_penguin_area_type = /area/club_penguin/plaza
	},
/turf/open/floor/grass/snow/actually_safe,
/area/club_penguin/cove)
"w" = (
/obj/effect/landmark/club_penguin_corner1,
/obj/effect/backdrop/cove,
/turf/cordon,
/area/club_penguin/cove)
"C" = (
/turf/open/floor/plating/beach/water,
/area/club_penguin/cove)
"F" = (
/turf/open/floor/grass/snow/actually_safe,
/area/club_penguin/cove)
"G" = (
/obj/effect/teleport_transition{
	club_penguin_area_type = /area/club_penguin/pizza_parlor
	},
/turf/cordon,
/area/club_penguin/cove)
"P" = (
/obj/effect/landmark/area_ambience/cove,
/turf/cordon,
/area/club_penguin/cove)
"X" = (
/turf/cordon,
/area/club_penguin/cove)

(1,1,1) = {"
X
X
X
X
X
X
X
X
X
X
X
X
X
X
X
X
"}
(2,1,1) = {"
X
X
X
X
X
X
X
X
F
F
X
X
X
X
w
X
"}
(3,1,1) = {"
X
X
X
X
X
X
X
F
F
F
F
X
X
X
P
X
"}
(4,1,1) = {"
X
X
X
X
X
X
X
F
F
F
F
F
X
X
X
X
"}
(5,1,1) = {"
X
X
X
X
k
X
X
F
F
F
F
F
F
X
X
X
"}
(6,1,1) = {"
X
X
X
X
F
F
X
F
F
a
F
F
F
X
X
X
"}
(7,1,1) = {"
X
X
X
X
X
F
F
F
F
F
F
F
F
X
X
X
"}
(8,1,1) = {"
X
X
X
X
X
F
F
F
F
F
F
F
C
C
C
X
"}
(9,1,1) = {"
X
X
X
X
F
X
F
F
F
F
F
C
C
C
C
X
"}
(10,1,1) = {"
X
X
X
X
F
F
F
F
F
F
F
C
C
C
C
X
"}
(11,1,1) = {"
X
X
X
X
X
F
F
F
F
F
C
C
C
C
C
X
"}
(12,1,1) = {"
X
X
X
X
X
F
F
F
F
F
C
C
C
C
C
X
"}
(13,1,1) = {"
X
X
X
X
X
F
F
F
F
F
C
C
C
C
C
X
"}
(14,1,1) = {"
X
X
X
X
X
X
X
F
F
F
C
C
C
C
C
X
"}
(15,1,1) = {"
X
X
X
X
X
X
X
X
F
F
C
C
C
C
C
X
"}
(16,1,1) = {"
X
X
X
X
X
X
X
X
F
F
C
C
C
C
C
X
"}
(17,1,1) = {"
X
X
X
X
X
X
X
G
F
F
C
C
C
C
C
X
"}
(18,1,1) = {"
X
X
X
X
X
X
X
F
F
F
C
C
C
C
C
X
"}
(19,1,1) = {"
X
X
X
X
X
X
X
F
F
F
C
C
C
C
X
X
"}
(20,1,1) = {"
i
X
X
X
X
X
X
X
X
X
X
C
C
C
X
X
"}
(21,1,1) = {"
X
X
X
X
X
X
X
X
X
X
X
X
X
X
X
X
"}
