//MAP CONVERTED BY dmm2tgm.py THIS HEADER COMMENT PREVENTS RECONVERSION, DO NOT REMOVE
"q" = (
/turf/open/floor/grass/snow/actually_safe,
/area/club_penguin/gift_shop)
"N" = (
/turf/cordon,
/area/club_penguin/gift_shop)
"Q" = (
/obj/effect/backdrop/gift_shop,
/obj/effect/landmark/club_penguin_corner1,
/turf/open/floor/grass/snow/actually_safe,
/area/club_penguin/gift_shop)
"R" = (
/obj/effect/landmark/area_ambience/gift_shop,
/turf/open/floor/grass/snow/actually_safe,
/area/club_penguin/gift_shop)
"V" = (
/obj/effect/landmark/club_penguin_corner2,
/turf/cordon,
/area/club_penguin/gift_shop)

(1,1,1) = {"
N
N
N
N
N
N
N
N
N
N
N
N
N
N
N
N
"}
(2,1,1) = {"
N
N
N
N
N
N
N
N
N
N
N
N
q
q
Q
N
"}
(3,1,1) = {"
N
N
N
N
N
N
N
N
N
N
N
q
q
q
R
N
"}
(4,1,1) = {"
N
N
N
N
N
N
N
N
N
q
q
q
q
q
q
N
"}
(5,1,1) = {"
N
N
N
N
N
N
N
N
q
q
q
q
q
q
q
N
"}
(6,1,1) = {"
N
N
N
N
N
N
N
N
q
q
q
q
q
q
q
N
"}
(7,1,1) = {"
N
N
N
N
N
N
N
N
q
q
q
q
q
q
q
N
"}
(8,1,1) = {"
N
N
N
N
N
N
N
N
q
q
q
q
q
q
q
N
"}
(9,1,1) = {"
N
N
N
N
N
N
q
q
q
q
q
q
q
q
q
N
"}
(10,1,1) = {"
N
N
N
N
N
N
q
q
q
q
q
q
q
q
q
N
"}
(11,1,1) = {"
N
N
N
N
N
N
q
q
q
q
q
q
q
q
q
N
"}
(12,1,1) = {"
N
N
N
N
N
N
q
q
q
q
q
q
q
q
q
N
"}
(13,1,1) = {"
N
N
N
N
N
N
N
q
q
q
q
q
q
q
q
N
"}
(14,1,1) = {"
N
N
q
q
q
q
q
q
q
q
q
q
q
q
q
N
"}
(15,1,1) = {"
N
N
q
q
q
q
q
q
q
q
q
q
q
q
q
N
"}
(16,1,1) = {"
N
N
N
N
N
N
N
N
N
N
q
q
q
q
q
N
"}
(17,1,1) = {"
N
N
N
N
N
N
N
N
N
N
N
q
q
q
q
N
"}
(18,1,1) = {"
N
N
N
N
N
N
N
N
N
N
N
q
q
q
q
N
"}
(19,1,1) = {"
N
N
N
N
N
N
N
N
N
N
N
q
q
q
q
N
"}
(20,1,1) = {"
V
N
N
N
N
N
N
N
N
q
q
q
q
q
q
N
"}
(21,1,1) = {"
N
N
N
N
N
N
N
N
N
N
N
N
N
N
N
N
"}
