//MAP CONVERTED BY dmm2tgm.py THIS HEADER COMMENT PREVENTS RECONVERSION, DO NOT REMOVE
"a" = (
/turf/open/floor/iron/white,
/area/club_penguin/iceberg)
"o" = (
/turf/cordon,
/area/club_penguin/iceberg)
"w" = (
/obj/effect/landmark/observer_start,
/turf/open/floor/iron/white,
/area/club_penguin/iceberg)
"K" = (
/obj/effect/backdrop/iceberg,
/obj/effect/landmark/club_penguin_corner1,
/turf/cordon,
/area/club_penguin/iceberg)
"L" = (
/obj/effect/landmark/club_penguin_corner2,
/turf/cordon,
/area/club_penguin/iceberg)

(1,1,1) = {"
o
o
o
o
o
o
o
o
o
o
o
o
o
o
K
"}
(2,1,1) = {"
o
o
o
o
o
o
o
a
a
a
o
o
o
o
o
"}
(3,1,1) = {"
o
o
o
o
o
o
a
a
a
a
a
o
o
o
o
"}
(4,1,1) = {"
o
o
o
o
a
o
a
a
a
a
a
o
o
o
o
"}
(5,1,1) = {"
o
o
o
a
a
a
a
a
a
a
a
a
o
o
o
"}
(6,1,1) = {"
o
o
a
a
a
a
a
a
a
a
a
a
o
o
o
"}
(7,1,1) = {"
o
a
a
a
a
a
a
a
a
a
a
a
o
o
o
"}
(8,1,1) = {"
a
a
a
a
a
a
a
a
a
a
a
a
o
o
o
"}
(9,1,1) = {"
a
a
a
a
a
a
a
a
a
a
a
a
o
o
o
"}
(10,1,1) = {"
o
a
a
a
a
a
a
a
a
a
a
a
o
o
o
"}
(11,1,1) = {"
o
a
a
a
a
a
a
a
a
a
a
a
o
o
o
"}
(12,1,1) = {"
o
a
a
a
a
a
a
w
a
a
a
a
a
o
o
"}
(13,1,1) = {"
o
o
a
a
a
a
a
a
a
a
a
a
a
o
o
"}
(14,1,1) = {"
o
o
a
a
a
a
a
a
a
a
a
a
a
o
o
"}
(15,1,1) = {"
o
o
o
a
a
a
a
a
a
a
a
a
a
o
o
"}
(16,1,1) = {"
o
o
o
a
a
a
a
a
a
a
a
a
a
o
o
"}
(17,1,1) = {"
o
o
o
a
a
a
a
a
a
a
a
a
a
o
o
"}
(18,1,1) = {"
o
o
o
a
a
a
a
a
a
a
a
a
o
o
o
"}
(19,1,1) = {"
o
o
o
a
a
a
a
a
a
a
a
a
o
o
o
"}
(20,1,1) = {"
o
o
o
o
a
a
a
a
a
a
a
a
o
o
o
"}
(21,1,1) = {"
o
o
o
o
a
a
a
a
a
a
a
a
o
o
o
"}
(22,1,1) = {"
o
o
o
o
a
a
a
a
a
a
a
a
o
o
o
"}
(23,1,1) = {"
o
o
o
o
o
a
a
a
a
a
a
a
o
o
o
"}
(24,1,1) = {"
o
o
o
o
o
o
a
a
a
a
a
o
o
o
o
"}
(25,1,1) = {"
o
o
o
o
o
o
a
a
a
a
o
o
o
o
o
"}
(26,1,1) = {"
L
o
o
o
o
o
o
o
o
o
o
o
o
o
o
"}
