//MAP CONVERTED BY dmm2tgm.py THIS HEADER COMMENT PREVENTS RECONVERSION, DO NOT REMOVE
"a" = (
/obj/effect/landmark/club_penguin_corner1,
/obj/effect/backdrop/night_club,
/obj/effect/backdrop/night_club/dance_floor,
/turf/cordon,
/area/club_penguin/night_club)
"c" = (
/obj/effect/landmark/club_penguin_corner2,
/turf/cordon,
/area/club_penguin/night_club)
"g" = (
/obj/effect/landmark/area_ambience/night_club,
/turf/cordon,
/area/club_penguin/night_club)
"l" = (
/turf/cordon,
/area/club_penguin/night_club)
"o" = (
/turf/open/floor/grass/snow/actually_safe,
/area/club_penguin/night_club)
"G" = (
/obj/effect/teleport_transition{
	club_penguin_area_type = /area/club_penguin/town
	},
/turf/open/floor/grass/snow/actually_safe,
/area/club_penguin/night_club)

(1,1,1) = {"
l
l
l
l
l
l
l
l
l
l
l
l
l
l
a
"}
(2,1,1) = {"
l
l
l
l
l
l
l
G
G
l
l
l
l
o
g
"}
(3,1,1) = {"
l
l
l
l
l
l
l
G
G
o
o
o
o
o
l
"}
(4,1,1) = {"
l
l
l
l
l
l
l
o
o
o
o
o
o
o
l
"}
(5,1,1) = {"
l
l
l
l
l
l
l
o
o
o
o
o
o
o
l
"}
(6,1,1) = {"
l
l
l
l
o
o
l
o
o
o
o
o
o
o
l
"}
(7,1,1) = {"
l
l
l
l
o
o
o
o
o
o
o
o
o
o
l
"}
(8,1,1) = {"
l
l
l
l
o
l
o
o
o
o
o
o
o
o
l
"}
(9,1,1) = {"
l
l
l
l
o
l
o
o
o
o
o
o
o
o
l
"}
(10,1,1) = {"
l
l
l
l
o
l
o
o
o
o
o
o
o
o
l
"}
(11,1,1) = {"
l
l
l
l
o
l
o
o
o
o
o
o
o
o
l
"}
(12,1,1) = {"
l
l
l
l
o
l
o
o
o
o
o
o
o
o
l
"}
(13,1,1) = {"
l
l
l
l
o
o
o
o
o
o
o
o
o
o
l
"}
(14,1,1) = {"
l
l
l
l
l
o
o
o
o
o
o
o
o
o
l
"}
(15,1,1) = {"
l
l
l
l
l
o
o
o
o
o
o
o
o
o
l
"}
(16,1,1) = {"
l
l
l
l
l
l
l
l
o
o
o
o
o
o
l
"}
(17,1,1) = {"
l
l
l
l
l
l
l
l
l
l
l
l
o
o
l
"}
(18,1,1) = {"
l
l
l
l
l
l
l
l
l
l
l
l
o
o
l
"}
(19,1,1) = {"
c
l
l
l
l
l
l
l
l
l
l
l
l
l
l
"}
