//MAP CONVERTED BY dmm2tgm.py THIS HEADER COMMENT PREVENTS RECONVERSION, DO NOT REMOVE
"a" = (
/turf/cordon,
/area/club_penguin/pizza_parlor)
"o" = (
/obj/effect/backdrop/pizza_parlor,
/obj/effect/landmark/club_penguin_corner1,
/turf/cordon,
/area/club_penguin/pizza_parlor)
"t" = (
/obj/effect/landmark/area_ambience/pizza_parlor,
/turf/cordon,
/area/club_penguin/pizza_parlor)
"w" = (
/obj/effect/landmark/club_penguin_corner2,
/turf/cordon,
/area/club_penguin/pizza_parlor)
"P" = (
/obj/effect/teleport_transition{
	club_penguin_area_type = /area/club_penguin/plaza
	},
/turf/open/floor/grass/snow/actually_safe,
/area/club_penguin/pizza_parlor)
"Z" = (
/turf/open/floor/grass/snow/actually_safe,
/area/club_penguin/pizza_parlor)

(1,1,1) = {"
a
a
a
a
a
a
a
a
a
a
a
a
a
a
o
a
"}
(2,1,1) = {"
a
a
a
a
a
a
a
a
a
a
a
a
a
a
t
a
"}
(3,1,1) = {"
a
a
a
a
a
a
a
a
a
a
a
a
a
a
a
a
"}
(4,1,1) = {"
a
a
a
a
a
a
Z
a
a
a
a
a
Z
Z
a
a
"}
(5,1,1) = {"
a
a
a
a
a
a
Z
Z
Z
Z
Z
Z
Z
Z
Z
a
"}
(6,1,1) = {"
a
a
a
a
a
a
Z
Z
Z
Z
Z
Z
Z
Z
Z
a
"}
(7,1,1) = {"
a
a
a
a
a
a
a
a
Z
Z
Z
Z
Z
Z
Z
a
"}
(8,1,1) = {"
a
a
a
a
a
a
a
a
Z
a
a
Z
Z
Z
Z
a
"}
(9,1,1) = {"
a
a
a
a
a
a
a
a
Z
a
a
Z
Z
Z
Z
a
"}
(10,1,1) = {"
a
a
a
a
a
a
a
a
Z
Z
Z
Z
Z
Z
Z
a
"}
(11,1,1) = {"
a
a
a
a
a
a
a
a
Z
Z
Z
Z
Z
Z
Z
a
"}
(12,1,1) = {"
a
a
a
a
a
a
a
Z
Z
Z
Z
a
a
Z
Z
a
"}
(13,1,1) = {"
a
a
a
a
a
P
Z
Z
Z
Z
Z
a
a
Z
Z
a
"}
(14,1,1) = {"
a
a
a
a
a
P
Z
Z
Z
Z
Z
Z
Z
Z
Z
a
"}
(15,1,1) = {"
a
a
a
a
a
P
Z
Z
Z
Z
Z
Z
Z
Z
Z
a
"}
(16,1,1) = {"
a
a
a
a
a
a
a
Z
Z
Z
Z
Z
Z
Z
Z
a
"}
(17,1,1) = {"
a
a
a
a
a
a
Z
Z
Z
Z
a
a
Z
Z
Z
a
"}
(18,1,1) = {"
a
a
a
a
a
a
Z
Z
Z
Z
a
a
Z
Z
Z
a
"}
(19,1,1) = {"
w
a
a
a
a
Z
Z
Z
Z
Z
Z
Z
Z
Z
Z
a
"}
(20,1,1) = {"
a
a
a
a
a
a
a
a
a
a
a
a
a
a
a
a
"}
