//MAP CONVERTED BY dmm2tgm.py THIS HEADER COMMENT PREVENTS RECONVERSION, DO NOT REMOVE
"i" = (
/obj/effect/landmark/club_penguin_corner2,
/turf/cordon,
/area/club_penguin/plaza)
"w" = (
/obj/effect/landmark/club_penguin_corner1,
/obj/effect/backdrop/plaza,
/turf/cordon,
/area/club_penguin/plaza)
"F" = (
/turf/open/floor/grass/snow/actually_safe,
/area/club_penguin/plaza)
"H" = (
/obj/effect/teleport_transition{
	club_penguin_area_type = /area/club_penguin/pizza_parlor
	},
/turf/open/floor/grass/snow/actually_safe,
/area/club_penguin/plaza)
"L" = (
/obj/effect/teleport_transition{
	club_penguin_area_type = /area/club_penguin/cove
	},
/turf/open/floor/grass/snow/actually_safe,
/area/club_penguin/plaza)
"P" = (
/obj/effect/landmark/area_ambience/plaza,
/turf/cordon,
/area/club_penguin/plaza)
"V" = (
/turf/cordon,
/area/club_penguin/plaza)
"X" = (
/obj/effect/teleport_transition{
	club_penguin_area_type = /area/club_penguin/town
	},
/turf/open/floor/grass/snow/actually_safe,
/area/club_penguin/plaza)

(1,1,1) = {"
V
V
V
V
V
V
V
V
V
V
V
V
V
V
V
V
"}
(2,1,1) = {"
V
V
V
V
V
V
X
F
F
V
V
V
V
V
w
V
"}
(3,1,1) = {"
V
V
V
V
V
V
V
V
F
F
V
V
V
V
P
V
"}
(4,1,1) = {"
V
V
V
V
V
V
V
V
F
F
F
F
V
V
F
V
"}
(5,1,1) = {"
V
V
V
V
V
V
V
V
F
F
F
F
F
F
F
V
"}
(6,1,1) = {"
V
V
V
V
V
V
V
V
F
F
F
F
V
V
F
V
"}
(7,1,1) = {"
V
V
V
V
V
V
V
V
F
F
F
F
V
V
F
V
"}
(8,1,1) = {"
V
V
V
V
V
V
V
V
F
F
F
F
F
F
F
V
"}
(9,1,1) = {"
V
V
V
V
V
V
V
F
F
F
F
F
F
F
F
V
"}
(10,1,1) = {"
V
V
V
V
V
V
V
V
F
F
F
F
F
F
F
V
"}
(11,1,1) = {"
V
V
V
V
V
V
V
F
F
F
F
F
F
V
F
V
"}
(12,1,1) = {"
V
V
V
V
V
V
V
F
F
F
F
F
V
V
F
V
"}
(13,1,1) = {"
V
V
V
V
V
V
F
F
F
F
F
F
V
V
F
V
"}
(14,1,1) = {"
V
V
V
V
V
V
F
F
F
F
F
F
V
V
F
V
"}
(15,1,1) = {"
V
V
V
V
V
V
V
F
F
F
F
F
F
F
F
V
"}
(16,1,1) = {"
V
V
V
V
V
V
H
F
F
F
F
F
F
F
F
V
"}
(17,1,1) = {"
V
V
V
V
V
V
H
F
F
F
F
F
F
F
F
V
"}
(18,1,1) = {"
V
V
V
V
V
V
V
V
V
F
F
V
V
F
V
V
"}
(19,1,1) = {"
V
V
V
V
V
V
V
V
V
F
F
V
F
V
V
V
"}
(20,1,1) = {"
i
V
V
V
V
V
V
V
V
L
F
V
F
V
V
V
"}
(21,1,1) = {"
V
V
V
V
V
V
V
V
V
V
V
V
V
V
V
V
"}
