//MAP CONVERTED BY dmm2tgm.py THIS HEADER COMMENT PREVENTS RECONVERSION, DO NOT REMOVE
"a" = (
/turf/cordon,
/area/club_penguin/ski_village)
"h" = (
/obj/effect/landmark/area_ambience/ski_village,
/turf/open/floor/grass/snow/actually_safe,
/area/club_penguin/ski_village)
"x" = (
/obj/effect/landmark/club_penguin_corner2,
/turf/cordon,
/area/club_penguin/ski_village)
"D" = (
/obj/effect/landmark/club_penguin_corner1,
/obj/effect/backdrop/ski_village,
/turf/open/floor/grass/snow/actually_safe,
/area/club_penguin/ski_village)
"T" = (
/turf/open/floor/grass/snow/actually_safe,
/area/club_penguin/ski_village)

(1,1,1) = {"
a
a
a
a
a
a
a
a
a
a
a
a
a
a
a
a
"}
(2,1,1) = {"
a
a
a
a
T
T
a
a
a
a
a
a
T
T
D
a
"}
(3,1,1) = {"
a
a
a
a
a
T
a
a
a
a
a
T
T
T
h
a
"}
(4,1,1) = {"
a
a
a
a
a
T
T
T
a
a
T
T
T
T
T
a
"}
(5,1,1) = {"
a
a
a
a
a
a
T
T
T
T
T
T
T
T
T
a
"}
(6,1,1) = {"
a
a
a
a
a
a
T
T
T
T
T
T
T
T
T
a
"}
(7,1,1) = {"
a
a
a
a
a
a
T
T
T
T
T
T
T
T
T
a
"}
(8,1,1) = {"
a
a
a
a
a
a
T
T
T
T
T
T
T
T
T
a
"}
(9,1,1) = {"
a
a
a
a
a
a
T
T
T
T
T
T
T
T
T
a
"}
(10,1,1) = {"
a
a
a
a
a
a
a
T
T
T
T
T
T
T
T
a
"}
(11,1,1) = {"
a
a
a
a
a
a
a
T
T
T
T
T
T
T
T
a
"}
(12,1,1) = {"
a
a
a
a
a
a
a
T
T
T
T
T
T
T
T
a
"}
(13,1,1) = {"
a
a
a
a
a
a
a
T
T
T
T
T
T
T
T
a
"}
(14,1,1) = {"
a
a
a
a
a
a
a
T
T
T
T
T
T
T
T
a
"}
(15,1,1) = {"
a
a
a
a
a
a
T
T
T
T
T
T
T
T
T
a
"}
(16,1,1) = {"
a
a
a
a
a
a
T
T
T
T
T
T
T
T
T
a
"}
(17,1,1) = {"
a
a
a
a
a
a
a
a
T
T
T
T
T
T
T
a
"}
(18,1,1) = {"
a
a
a
a
a
a
a
a
a
T
T
T
T
T
T
a
"}
(19,1,1) = {"
a
a
a
a
a
a
a
a
a
T
T
T
T
T
T
a
"}
(20,1,1) = {"
x
a
a
a
a
a
a
a
a
a
T
T
T
T
T
a
"}
(21,1,1) = {"
a
a
a
a
a
a
a
a
a
a
a
a
a
a
a
a
"}
