//MAP CONVERTED BY dmm2tgm.py THIS HEADER COMMENT PREVENTS RECONVERSION, DO NOT REMOVE
"a" = (
/obj/effect/landmark/club_penguin_corner2,
/turf/cordon,
/area/club_penguin/town)
"e" = (
/obj/effect/teleport_transition{
	club_penguin_area_type = /area/club_penguin/beach
	},
/turf/open/floor/grass/snow/actually_safe,
/area/club_penguin/town)
"g" = (
/obj/effect/teleport_transition{
	club_penguin_area_type = /area/club_penguin/plaza
	},
/turf/open/floor/grass/snow/actually_safe,
/area/club_penguin/town)
"r" = (
/obj/effect/backdrop/town,
/obj/effect/landmark/club_penguin_corner1,
/turf/cordon,
/area/club_penguin/town)
"s" = (
/obj/effect/landmark/observer_start,
/turf/open/floor/grass/snow/actually_safe,
/area/club_penguin/town)
"w" = (
/obj/effect/landmark/area_ambience/town,
/turf/cordon,
/area/club_penguin/town)
"E" = (
/obj/effect/teleport_transition{
	club_penguin_area_type = /area/club_penguin/night_club
	},
/turf/open/floor/grass/snow/actually_safe,
/area/club_penguin/town)
"F" = (
/turf/open/floor/grass/snow/actually_safe,
/area/club_penguin/town)
"K" = (
/obj/effect/teleport_transition{
	club_penguin_area_type = /area/club_penguin/gift_shop
	},
/turf/open/floor/grass/snow/actually_safe,
/area/club_penguin/town)
"N" = (
/obj/effect/teleport_transition{
	club_penguin_area_type = /area/club_penguin/coffee_shop
	},
/turf/open/floor/grass/snow/actually_safe,
/area/club_penguin/town)
"V" = (
/turf/cordon,
/area/club_penguin/town)

(1,1,1) = {"
V
V
V
V
V
V
V
V
V
V
V
V
V
V
r
V
"}
(2,1,1) = {"
V
V
V
V
V
V
V
V
F
e
e
V
V
V
w
V
"}
(3,1,1) = {"
V
V
V
V
V
V
V
V
F
F
F
V
V
V
V
V
"}
(4,1,1) = {"
V
V
V
V
V
V
V
V
F
F
F
F
V
V
V
V
"}
(5,1,1) = {"
V
V
V
V
V
V
V
F
F
F
F
F
F
V
V
V
"}
(6,1,1) = {"
V
V
V
V
V
V
V
V
V
F
F
F
F
F
F
V
"}
(7,1,1) = {"
V
V
V
V
V
V
N
F
F
F
F
F
F
F
F
V
"}
(8,1,1) = {"
V
V
V
V
V
V
V
F
F
F
F
F
F
F
F
V
"}
(9,1,1) = {"
V
V
V
V
V
F
E
F
F
F
F
F
F
F
F
V
"}
(10,1,1) = {"
V
V
V
V
V
V
E
F
F
s
F
F
F
F
F
V
"}
(11,1,1) = {"
V
V
V
V
V
V
V
F
F
F
F
F
F
F
F
V
"}
(12,1,1) = {"
V
V
V
V
V
V
V
F
F
F
F
F
F
F
F
V
"}
(13,1,1) = {"
V
V
V
V
V
V
V
F
F
F
F
F
F
F
F
V
"}
(14,1,1) = {"
V
V
V
V
V
V
K
F
F
F
F
F
F
F
F
V
"}
(15,1,1) = {"
V
V
V
V
V
V
K
F
F
F
F
F
F
V
V
V
"}
(16,1,1) = {"
V
V
V
V
V
V
V
V
V
V
F
F
F
V
V
V
"}
(17,1,1) = {"
V
V
V
V
V
V
V
V
V
F
F
F
V
V
V
V
"}
(18,1,1) = {"
V
V
V
V
V
V
V
V
V
F
F
V
V
V
V
V
"}
(19,1,1) = {"
a
V
V
V
V
V
V
V
V
g
g
V
V
V
V
V
"}
(20,1,1) = {"
V
V
V
V
V
V
V
V
V
V
V
V
V
V
V
V
"}
