//MAP CONVERTED BY dmm2tgm.py THIS HEADER COMMENT PREVENTS RECONVERSION, DO NOT REMOVE
"a" = (
/obj/effect/landmark/club_penguin_corner1,
/obj/effect/backdrop/town,
/turf/cordon,
/area/club_penguin/town)
"e" = (
/turf/open/floor/grass,
/area/club_penguin/town)
"n" = (
/obj/effect/landmark/observer_start,
/turf/open/floor/grass,
/area/club_penguin/town)
"r" = (
/obj/effect/landmark/area_ambience/town,
/turf/cordon,
/area/club_penguin/town)
"F" = (
/obj/effect/landmark/club_penguin_corner2,
/turf/cordon,
/area/club_penguin/town)
"V" = (
/turf/cordon,
/area/club_penguin/town)

(1,1,1) = {"
V
V
V
V
V
V
V
V
V
V
V
V
V
V
V
V
V
a
"}
(2,1,1) = {"
V
V
V
V
V
V
V
V
V
V
V
e
V
V
V
V
V
r
"}
(3,1,1) = {"
V
V
V
V
V
V
V
V
V
V
V
e
e
V
V
V
V
V
"}
(4,1,1) = {"
V
V
V
V
V
V
V
V
V
V
V
e
e
e
V
V
V
V
"}
(5,1,1) = {"
V
V
V
V
V
V
V
V
V
V
V
e
e
e
e
V
V
V
"}
(6,1,1) = {"
V
V
V
V
V
V
V
V
V
V
V
e
e
e
e
e
V
V
"}
(7,1,1) = {"
V
V
V
V
V
V
V
V
V
V
V
e
e
e
e
e
V
V
"}
(8,1,1) = {"
V
V
V
V
V
V
V
V
V
e
e
e
e
e
e
e
e
e
"}
(9,1,1) = {"
V
V
V
V
V
V
V
V
e
e
e
e
e
e
e
e
e
e
"}
(10,1,1) = {"
V
V
V
V
V
V
V
V
e
e
e
e
e
e
e
e
e
e
"}
(11,1,1) = {"
V
V
V
V
V
V
V
V
e
e
e
e
e
e
e
e
e
e
"}
(12,1,1) = {"
V
V
V
V
V
V
V
V
e
e
e
e
n
e
e
e
e
e
"}
(13,1,1) = {"
V
V
V
V
V
V
V
V
e
e
e
e
e
e
e
e
e
e
"}
(14,1,1) = {"
V
V
V
V
V
V
V
V
e
e
e
e
e
e
e
e
e
e
"}
(15,1,1) = {"
V
V
V
V
V
V
V
V
e
e
e
e
e
e
e
e
e
e
"}
(16,1,1) = {"
V
V
V
V
V
V
V
V
V
e
e
e
e
e
e
e
e
e
"}
(17,1,1) = {"
V
V
V
V
V
V
V
V
V
e
e
e
e
e
e
e
e
e
"}
(18,1,1) = {"
V
V
V
V
V
V
V
V
e
e
e
e
e
e
e
e
e
e
"}
(19,1,1) = {"
V
V
V
V
V
V
V
V
V
V
e
e
e
e
e
e
e
V
"}
(20,1,1) = {"
V
V
V
V
V
V
V
V
V
V
V
V
e
e
e
e
V
V
"}
(21,1,1) = {"
V
V
V
V
V
V
V
V
V
V
V
V
e
e
e
e
V
V
"}
(22,1,1) = {"
V
V
V
V
V
V
V
V
V
V
V
e
e
e
e
V
V
V
"}
(23,1,1) = {"
V
V
V
V
V
V
V
V
V
V
V
e
e
e
V
V
V
V
"}
(24,1,1) = {"
V
V
V
V
V
V
V
V
V
V
e
e
e
V
V
V
V
V
"}
(25,1,1) = {"
F
V
V
V
V
V
V
V
V
V
e
e
V
V
V
V
V
V
"}
