//MAP CONVERTED BY dmm2tgm.py THIS HEADER COMMENT PREVENTS RECONVERSION, DO NOT REMOVE
"a" = (
/turf/open/floor/grass,
/area/awaymission/secret/powered/fullbright)
"k" = (
/turf/closed/indestructible/reinforced,
/area/awaymission/secret/powered/fullbright)
"m" = (
/turf/closed/wall,
/area/awaymission/secret/powered/fullbright)
"r" = (
/obj/effect/landmark/train_landing_position,
/turf/open/floor/carpet/cyan,
/area/awaymission/secret/powered/fullbright)
"C" = (
/turf/open/floor/carpet/cyan,
/area/awaymission/secret/powered/fullbright)

(1,1,1) = {"
k
k
k
k
k
k
k
k
k
k
k
k
k
k
k
k
k
k
k
k
k
k
k
k
k
k
k
k
k
k
k
k
k
k
k
k
k
k
k
k
k
k
k
k
k
k
k
k
k
k
k
"}
(2,1,1) = {"
k
a
a
a
a
a
a
a
a
a
a
a
a
a
a
a
a
a
a
a
a
a
a
a
a
a
a
a
a
a
a
a
a
a
a
a
a
a
a
a
a
a
a
a
a
a
a
a
a
a
k
"}
(3,1,1) = {"
k
a
a
a
a
a
a
a
a
a
a
a
a
a
a
a
a
a
a
a
a
a
a
a
a
a
a
a
a
a
a
a
a
a
a
a
a
a
a
a
a
a
a
a
a
a
a
a
a
a
k
"}
(4,1,1) = {"
k
a
a
a
a
a
a
a
a
a
a
a
a
a
a
a
a
a
a
a
a
a
a
a
a
a
a
a
a
a
a
a
a
a
a
a
a
a
a
a
a
a
a
a
a
a
a
a
a
a
k
"}
(5,1,1) = {"
k
a
a
a
a
a
a
a
a
a
a
a
a
a
a
a
a
a
a
a
a
a
a
a
a
a
a
a
a
a
a
a
a
a
a
a
a
a
a
a
a
a
a
a
a
a
a
a
a
a
k
"}
(6,1,1) = {"
k
a
a
a
a
a
a
a
a
a
a
a
a
a
a
a
a
a
a
a
a
a
a
a
a
a
a
a
a
a
a
a
a
a
a
a
a
a
a
a
a
a
a
a
a
a
a
a
a
a
k
"}
(7,1,1) = {"
k
a
a
a
a
a
a
a
a
a
a
a
a
a
a
a
a
a
a
a
a
a
a
a
a
a
a
a
a
a
a
a
a
a
a
a
a
a
a
a
a
a
a
a
a
a
a
a
a
a
k
"}
(8,1,1) = {"
k
a
a
a
a
a
a
a
a
a
a
a
a
a
a
a
a
a
a
a
a
a
a
a
a
a
a
a
a
a
a
a
a
a
a
a
a
a
a
a
a
a
a
a
a
a
a
a
a
a
k
"}
(9,1,1) = {"
k
a
a
a
a
a
a
a
a
a
a
a
a
a
a
a
a
a
a
a
a
a
a
a
a
a
a
a
a
a
a
a
a
a
a
a
a
a
a
a
a
a
a
a
a
a
a
a
a
a
k
"}
(10,1,1) = {"
k
a
a
a
a
a
a
a
a
a
a
a
a
a
a
a
a
a
a
a
a
a
a
a
a
a
a
a
a
a
a
a
a
a
a
a
a
a
a
a
a
a
a
a
a
a
a
a
a
a
k
"}
(11,1,1) = {"
k
a
a
a
a
a
a
a
a
a
a
a
a
a
a
a
a
a
a
a
a
a
a
a
a
a
a
a
C
C
C
C
C
C
C
C
C
a
a
a
a
a
a
a
a
a
a
a
a
a
k
"}
(12,1,1) = {"
k
a
a
a
a
a
a
a
a
a
a
a
a
a
a
a
a
a
a
a
a
a
a
a
a
a
a
a
C
C
C
C
C
C
C
C
C
a
a
a
a
a
a
a
a
a
a
a
a
a
k
"}
(13,1,1) = {"
k
a
a
a
a
a
a
a
a
a
a
a
a
a
a
a
a
a
a
a
a
a
a
a
a
a
a
a
C
C
C
C
C
C
C
C
C
a
a
a
a
a
a
a
a
a
a
a
a
a
k
"}
(14,1,1) = {"
k
a
a
a
a
a
a
a
a
a
a
a
a
a
a
a
a
a
a
a
a
a
a
a
a
a
a
a
C
C
m
m
m
m
C
m
C
a
a
a
a
a
a
a
a
a
a
a
a
a
k
"}
(15,1,1) = {"
k
a
a
a
a
a
a
a
a
a
a
a
a
a
a
a
a
a
a
a
a
a
a
a
a
a
a
m
m
C
C
C
C
C
C
m
m
a
a
a
a
a
a
a
a
a
a
a
a
a
k
"}
(16,1,1) = {"
k
a
a
a
a
a
a
a
a
a
a
a
a
a
a
a
a
a
a
a
a
a
a
a
a
a
a
a
C
C
C
C
C
C
C
C
C
m
a
a
a
a
a
a
a
a
a
a
a
a
k
"}
(17,1,1) = {"
k
a
a
a
a
a
a
a
a
a
a
a
a
a
a
a
a
a
a
a
a
a
a
a
a
a
a
a
C
C
C
C
C
C
C
C
C
m
a
a
a
a
a
a
a
a
a
a
a
a
k
"}
(18,1,1) = {"
k
a
a
a
a
a
a
a
a
a
a
a
a
a
a
a
a
a
a
a
a
a
a
a
a
a
a
a
C
C
C
C
C
C
C
C
C
a
a
a
a
a
a
a
a
a
a
a
a
a
k
"}
(19,1,1) = {"
k
a
a
a
a
a
a
a
a
a
a
a
a
a
a
a
a
a
a
m
a
a
a
a
a
a
a
a
C
C
C
C
C
C
C
C
C
a
a
a
a
a
a
a
a
a
a
a
a
a
k
"}
(20,1,1) = {"
k
a
a
a
a
a
a
a
a
a
a
a
a
a
a
a
a
a
a
m
m
m
m
a
m
m
a
a
C
C
m
m
m
C
C
m
m
a
a
a
a
a
a
a
a
a
a
a
a
a
k
"}
(21,1,1) = {"
k
a
a
a
a
a
a
a
a
a
a
a
a
a
a
a
a
a
a
m
a
a
a
a
a
a
a
a
C
C
C
C
C
C
C
C
C
m
m
a
a
a
a
a
a
a
a
a
a
a
k
"}
(22,1,1) = {"
k
a
a
a
a
a
a
a
a
a
a
a
a
a
a
a
a
a
r
C
C
C
C
C
C
C
C
C
C
C
C
C
C
C
C
C
C
C
C
C
C
C
C
C
C
a
a
a
a
a
k
"}
(23,1,1) = {"
k
a
a
a
a
a
a
a
a
a
a
a
a
a
a
a
a
m
C
C
C
C
C
C
C
C
C
C
C
C
C
C
C
C
C
C
C
C
C
C
C
C
C
C
C
a
a
a
a
a
k
"}
(24,1,1) = {"
k
a
a
a
a
a
a
a
a
a
a
a
a
a
a
a
a
a
C
C
C
C
C
C
C
C
C
C
C
C
C
C
C
C
C
C
C
C
C
C
C
C
C
C
C
a
a
a
a
a
k
"}
(25,1,1) = {"
k
a
a
a
a
a
a
a
a
a
a
a
a
a
a
a
a
m
C
C
C
C
C
C
C
C
C
C
C
C
C
C
C
C
C
C
C
C
C
C
C
C
C
C
C
a
a
a
a
a
k
"}
(26,1,1) = {"
k
a
a
a
a
a
a
a
a
a
a
a
a
a
a
a
a
m
C
C
C
C
C
C
C
C
C
C
C
C
C
C
C
C
C
C
C
C
C
C
C
C
C
C
C
a
a
a
a
a
k
"}
(27,1,1) = {"
k
a
a
a
a
a
a
a
a
a
a
a
a
a
m
a
a
m
C
C
C
C
C
C
C
C
C
C
C
C
C
C
C
C
C
C
C
C
C
C
C
C
C
C
C
a
a
a
a
a
k
"}
(28,1,1) = {"
k
a
a
a
a
a
a
a
a
a
a
a
a
a
a
a
a
a
C
C
C
C
C
C
C
C
C
C
C
C
C
C
C
C
C
C
C
C
C
C
C
C
C
C
C
a
a
a
a
a
k
"}
(29,1,1) = {"
k
a
a
a
a
a
a
a
a
a
a
a
a
a
a
a
a
a
C
C
C
C
C
C
C
C
C
C
C
C
C
C
C
C
C
C
C
C
C
C
C
C
C
C
C
a
a
a
a
a
k
"}
(30,1,1) = {"
k
a
a
a
a
a
a
a
a
a
a
a
a
a
m
a
a
a
C
C
C
C
C
C
C
C
C
C
C
C
C
C
C
C
C
C
C
C
C
C
C
C
C
C
C
a
a
a
a
a
k
"}
(31,1,1) = {"
k
a
a
a
a
a
a
a
a
a
a
a
a
a
a
a
a
a
C
C
C
C
C
C
C
C
C
C
C
C
C
C
C
C
C
C
C
C
C
C
C
C
C
C
C
a
a
a
a
a
k
"}
(32,1,1) = {"
k
a
a
a
a
a
a
a
a
a
a
a
a
a
a
a
a
a
C
C
C
C
C
C
C
C
C
C
C
C
C
C
C
C
C
C
C
C
C
C
C
C
C
C
C
a
a
a
a
a
k
"}
(33,1,1) = {"
k
a
a
a
a
a
a
a
a
a
a
a
a
m
a
a
a
a
C
C
C
C
C
C
C
C
C
C
C
C
C
C
C
C
C
C
C
C
C
C
C
C
C
C
C
a
a
a
a
a
k
"}
(34,1,1) = {"
k
a
a
a
a
a
a
a
a
a
a
a
a
a
a
a
a
a
C
C
C
C
C
C
C
C
C
C
C
C
C
C
C
C
C
C
C
C
C
C
C
C
C
C
C
a
a
a
a
a
k
"}
(35,1,1) = {"
k
a
a
a
a
a
a
a
a
a
a
a
a
m
a
a
a
a
C
C
C
C
C
C
C
C
C
C
C
C
C
C
C
C
C
C
C
C
C
C
C
C
C
C
C
a
a
a
a
a
k
"}
(36,1,1) = {"
k
a
a
a
a
a
a
a
a
a
a
a
a
a
a
a
a
a
C
C
C
C
C
C
C
C
C
C
C
C
C
C
C
C
C
C
C
C
C
C
C
C
C
C
C
a
a
a
a
a
k
"}
(37,1,1) = {"
k
a
a
a
a
a
a
a
a
a
a
a
a
m
a
a
a
a
C
C
C
C
C
m
C
C
C
C
C
C
C
C
C
C
C
C
C
C
C
C
C
m
C
C
C
a
a
a
a
a
k
"}
(38,1,1) = {"
k
a
a
a
a
a
a
a
a
a
a
a
a
a
a
a
a
a
C
C
C
m
m
m
m
m
C
C
C
C
C
C
C
C
C
C
C
C
m
C
C
C
m
C
C
a
a
a
a
a
k
"}
(39,1,1) = {"
k
a
a
a
a
a
a
a
a
a
a
a
a
a
a
a
a
a
m
m
C
C
C
C
m
C
C
C
C
C
C
C
C
C
m
m
m
m
C
C
C
C
C
C
C
a
a
a
a
a
k
"}
(40,1,1) = {"
k
a
a
a
a
a
a
a
a
a
a
a
a
a
a
a
a
a
C
C
C
C
C
C
m
C
C
C
C
C
C
C
C
C
C
C
C
C
C
C
C
C
C
C
C
a
a
a
a
a
k
"}
(41,1,1) = {"
k
a
a
a
a
a
a
a
a
a
a
a
a
a
a
a
a
a
C
C
C
C
m
C
m
C
C
C
C
C
m
m
C
C
C
C
C
C
C
C
C
C
C
C
C
a
a
a
a
a
k
"}
(42,1,1) = {"
k
a
a
a
a
a
a
a
a
a
a
a
a
a
a
a
a
a
C
C
C
C
C
C
C
C
C
C
C
C
m
C
C
C
C
C
C
C
C
C
C
C
C
C
C
a
a
a
a
a
k
"}
(43,1,1) = {"
k
a
a
a
a
a
a
a
a
a
a
a
a
a
a
a
a
m
a
a
a
a
a
a
a
m
a
a
C
C
C
m
C
C
C
C
C
a
a
a
a
a
a
a
a
a
a
a
a
a
k
"}
(44,1,1) = {"
k
a
a
a
a
a
a
a
a
a
a
a
a
a
a
a
a
a
a
a
a
a
a
a
a
a
a
a
C
C
m
C
C
C
C
C
C
a
a
a
a
a
a
a
a
a
a
a
a
a
k
"}
(45,1,1) = {"
k
a
a
a
a
a
a
a
a
a
a
a
a
a
a
a
a
a
m
a
a
a
a
a
a
a
a
a
C
m
C
C
C
C
C
C
C
a
a
a
a
a
a
a
a
a
a
a
a
a
k
"}
(46,1,1) = {"
k
a
a
a
a
a
a
a
a
a
a
a
a
a
a
a
a
a
a
m
a
a
a
a
a
a
a
a
C
C
C
C
C
m
C
C
C
a
a
a
a
a
a
a
a
a
a
a
a
a
k
"}
(47,1,1) = {"
k
a
a
a
a
a
a
a
a
a
a
a
a
a
a
a
a
a
a
a
m
a
a
m
m
m
m
a
C
C
C
C
m
m
C
C
C
a
a
a
a
a
a
a
a
a
a
a
a
a
k
"}
(48,1,1) = {"
k
a
a
a
a
a
a
a
a
a
a
a
a
a
a
a
a
a
a
a
a
a
a
a
a
a
a
a
C
C
C
C
C
C
C
C
C
a
a
a
a
a
a
a
a
a
a
a
a
a
k
"}
(49,1,1) = {"
k
a
a
a
a
a
a
a
a
a
a
a
a
a
a
a
a
a
a
a
a
a
a
a
a
a
a
a
C
C
C
C
C
C
C
C
C
a
a
a
a
a
a
a
a
a
a
a
a
a
k
"}
(50,1,1) = {"
k
a
a
a
a
a
a
a
a
a
a
a
a
a
a
a
a
a
a
a
a
a
a
a
a
a
a
a
C
C
C
C
C
C
C
C
C
a
a
a
a
a
a
a
a
a
a
a
a
a
k
"}
(51,1,1) = {"
k
a
a
a
a
a
a
a
a
a
a
a
a
a
a
a
a
a
a
a
a
a
a
a
a
a
a
a
C
C
C
C
C
C
C
C
C
a
a
a
a
a
a
a
a
a
a
a
a
a
k
"}
(52,1,1) = {"
k
a
a
a
a
a
a
a
a
a
a
a
a
a
a
a
a
a
a
a
a
a
a
a
a
a
a
a
C
C
C
C
C
C
C
C
C
a
a
a
a
a
a
a
a
a
a
a
a
a
k
"}
(53,1,1) = {"
k
a
a
a
a
a
a
a
a
a
a
a
a
a
a
a
a
a
a
a
a
a
a
a
a
a
a
a
C
C
C
C
C
C
C
C
C
a
a
a
a
a
a
a
a
a
a
a
a
a
k
"}
(54,1,1) = {"
k
a
a
a
a
a
a
a
a
a
a
a
a
a
a
a
a
a
a
a
a
a
a
a
a
a
a
a
C
C
C
C
C
C
C
C
C
a
a
a
a
a
a
a
a
a
a
a
a
a
k
"}
(55,1,1) = {"
k
a
a
a
a
a
a
a
a
a
a
a
a
a
a
a
a
a
a
a
a
a
a
a
a
a
a
a
C
C
C
C
C
C
C
C
C
a
a
a
a
a
a
a
a
a
a
a
a
a
k
"}
(56,1,1) = {"
k
a
a
a
a
a
a
a
a
a
a
a
a
a
a
a
a
a
a
a
a
a
a
a
a
a
a
a
C
C
C
C
C
C
C
C
C
a
a
a
a
a
a
a
a
a
a
a
a
a
k
"}
(57,1,1) = {"
k
a
a
a
a
a
a
a
a
a
a
a
a
a
a
a
a
a
a
a
a
a
a
a
a
a
a
a
a
a
a
a
a
a
a
a
a
a
a
a
a
a
a
a
a
a
a
a
a
a
k
"}
(58,1,1) = {"
k
a
a
a
a
a
a
a
a
a
a
a
a
a
a
a
a
a
a
a
a
a
a
a
a
a
a
a
a
a
a
a
a
a
a
a
a
a
a
a
a
a
a
a
a
a
a
a
a
a
k
"}
(59,1,1) = {"
k
a
a
a
a
a
a
a
a
a
a
a
a
a
a
a
a
a
a
a
a
a
a
a
a
a
a
a
a
a
a
a
a
a
a
a
a
a
a
a
a
a
a
a
a
a
a
a
a
a
k
"}
(60,1,1) = {"
k
a
a
a
a
a
a
a
a
a
a
a
a
a
a
a
a
a
a
a
a
a
a
a
a
a
a
a
a
a
a
a
a
a
a
a
a
a
a
a
a
a
a
a
a
a
a
a
a
a
k
"}
(61,1,1) = {"
k
k
k
k
k
k
k
k
k
k
k
k
k
k
k
k
k
k
k
k
k
k
k
k
k
k
k
k
k
k
k
k
k
k
k
k
k
k
k
k
k
k
k
k
k
k
k
k
k
k
k
"}
