//MAP CONVERTED BY dmm2tgm.py THIS HEADER COMMENT PREVENTS RECONVERSION, DO NOT REMOVE
"a" = (
/turf/cordon,
/area/cordon)
"b" = (
/obj/effect/landmark/observer_start,
/turf/open/floor/iron,
/area/club_penguin/demo1)
"g" = (
/turf/open/floor/iron/checker,
/area/club_penguin/demo1)
"j" = (
/obj/effect/landmark/club_penguin_corner1,
/turf/open/floor/iron/checker,
/area/club_penguin/demo1)
"m" = (
/obj/structure/table/glass,
/turf/open/floor/iron/checker,
/area/club_penguin/demo1)
"x" = (
/obj/structure/statue/snow/snowman,
/turf/open/floor/iron/cafeteria,
/area/club_penguin/demo1)
"C" = (
/turf/open/floor/iron/cafeteria,
/area/club_penguin/demo1)
"V" = (
/obj/structure/table/bronze,
/turf/open/floor/iron/checker,
/area/club_penguin/demo1)
"W" = (
/obj/effect/landmark/club_penguin_corner2,
/turf/open/floor/iron/checker,
/area/club_penguin/demo1)

(1,1,1) = {"
a
a
a
a
a
a
a
a
a
a
a
a
a
a
a
a
a
"}
(2,1,1) = {"
a
g
g
g
g
g
g
g
g
g
g
g
g
g
g
j
a
"}
(3,1,1) = {"
a
g
g
g
g
g
g
g
g
g
g
g
V
V
V
V
a
"}
(4,1,1) = {"
a
g
g
g
g
g
g
g
g
g
g
g
V
g
g
V
a
"}
(5,1,1) = {"
a
g
g
g
g
g
g
g
g
g
g
g
V
g
g
V
a
"}
(6,1,1) = {"
a
g
g
g
g
g
g
g
g
g
g
g
g
g
g
g
a
"}
(7,1,1) = {"
a
g
g
g
g
g
C
C
C
C
C
g
V
V
V
V
a
"}
(8,1,1) = {"
a
g
g
g
g
g
C
C
C
C
C
g
V
g
V
g
a
"}
(9,1,1) = {"
a
g
g
g
g
g
x
C
b
C
C
g
V
V
V
g
a
"}
(10,1,1) = {"
a
g
g
g
g
g
C
C
C
C
C
g
g
g
g
g
a
"}
(11,1,1) = {"
a
g
g
g
g
g
C
C
C
C
C
g
g
g
g
g
a
"}
(12,1,1) = {"
a
g
g
g
g
g
g
g
g
g
g
g
g
g
m
g
a
"}
(13,1,1) = {"
a
g
g
g
g
g
g
g
g
g
g
g
m
g
g
m
a
"}
(14,1,1) = {"
a
g
g
g
g
g
g
g
g
g
g
g
g
g
g
m
a
"}
(15,1,1) = {"
a
g
g
g
g
g
g
g
g
g
g
g
m
g
g
m
a
"}
(16,1,1) = {"
a
W
g
g
g
g
g
g
g
g
g
g
g
g
m
g
a
"}
(17,1,1) = {"
a
a
a
a
a
a
a
a
a
a
a
a
a
a
a
a
a
"}
